14 5
1 4
w w w w w w w w w w w w w w
w g g g g g g g g g g g g w
w g g g g g g g g g g g g w
w g g g g g g g g g g g g w
w g w w w w w w w w w w c w